^^^^^1^^^^^
^^^^121^^^^
^^^12321^^^
^^1234321^^
^223343322^